1号线	富锦路,友谊西路,宝安公路,共富新村,呼兰路,通河新村,共康路,彭浦新村,汶水路,上海马戏城,延长路,中山北路,上海火车站,汉中路,新闸路,人民广场,黄陂南路,陕西南路,常熟路,衡山路,徐家汇,上海体育馆,漕宝路,上海南站,锦江乐园,莲花路,外环路,莘庄
2号线A	徐泾东,虹桥火车站,虹桥2号航站楼,淞虹路,北新泾,威宁路,娄山关路,中山公园,江苏路,静安寺,南京西路,人民广场,南京东路,陆家嘴,东昌路,世纪大道,上海科技馆,世纪公园,龙阳路,张江高科,金科路,广兰路,唐镇
2号线B	广兰路,唐镇,创新中路,华夏东路,川沙,凌空路,远东大道,海天三路,浦东国际机场
3号线	上海南站,石龙路,龙漕路,漕溪路,宜山路,虹桥路,延安西路,中山公园,金沙江路,曹杨路,镇坪路,中潭路,上海火车站,宝山路,东宝兴路,虹口足球场,赤峰路,大柏树,江湾镇,殷高西路,长江南路,淞发路,张华浜,淞滨路,水产路,宝杨路,友谊路,铁力路,江杨北路
4号线	宜山路,虹桥路,延安西路,中山公园,金沙江路,曹杨路,镇坪路,中潭路,上海火车站,宝山路,海伦路,临平路,大连路,杨树浦路,浦东大道,世纪大道,浦电路,蓝村路,塘桥,南浦大桥,西藏南路,鲁班路,大木桥路,东安路,上海体育场,上海体育馆
5号线支线	东川路,金平路,华宁路,文井路,闵行开发区
5号线	莘庄,春申路,银都路,颛桥,北桥,剑川路,东川路,江川路,西渡,萧塘,奉浦大道,环城东路,望园路,金海湖,奉贤新城
6号线	港城路,外高桥保税区北,航津路,外高桥保税区南,洲海路,五洲大道,东靖路,巨峰路,五莲路,博兴路,金桥路,云山路,德平路,北洋泾路,民生路,源深体育中心,世纪大道,浦电路,蓝村路,上海儿童医学中心,临沂新村,高科西路,东明路,高青路,华夏西路,上南路,灵岩南路,东方体育中心
7号线	美兰湖,罗南新村,潘广路,刘行,顾村公园,祁华路,上海大学,南陈路,上大路,场中路,大场镇,行知路,大华三路,新村路,岚皋路,镇坪路,长寿路,昌平路,静安寺,常熟路,肇嘉浜路,东安路,龙华中路,后滩,长清路,耀华路,云台路,高科西路,杨高南路,锦绣路,芳华路,龙阳路,花木路
8号线	市光路,嫩江路,翔殷路,黄兴公园,延吉中路,黄兴路,江浦路,鞍山新村,四平路,曲阳路,虹口足球场,西藏北路,中兴路,曲阜路,人民广场,大世界,老西门,陆家浜路,西藏南路,中华艺术宫,耀华路,成山路,杨思,东方体育中心,凌兆新村,芦恒路,浦江镇,江月路,联航路,沈杜公路
浦江线	沈杜公路,三鲁公路,闵瑞路,浦航路,东城一路,汇臻路
9号线	松江南站,醉白池,松江体育中心,松江新城,松江大学城,洞泾,佘山,泗泾,九亭,中春路,七宝,星中路,合川路,漕河泾开发区,桂林路,宜山路,徐家汇,肇嘉浜路,嘉善路,打浦桥,马当路,陆家浜路,小南门,商城路,世纪大道,杨高中路,芳甸路,蓝天路,台儿庄路,金桥,金吉路,金海路,顾唐路,民雷路,曹路
10号线A	新江湾城,殷高东路,三门路,江湾体育场,五角场,国权路,同济大学,四平路,邮电新村,海伦路,四川北路,天潼路,南京东路,豫园,老西门,新天地,陕西南路,上海图书馆 ,交通大学,虹桥路,宋园路,伊犁路,水城路,龙溪路,龙柏新村,紫藤路,航中路
10号线B	新江湾城,殷高东路,三门路,江湾体育场,五角场,国权路,同济大学,四平路,邮电新村,海伦路,四川北路,天潼路,南京东路,豫园,老西门,新天地,陕西南路,上海图书馆 ,交通大学,虹桥路,宋园路,伊犁路,水城路,龙溪路,上海动物园,虹桥1号航站楼,虹桥2号航站楼,虹桥火车站
11号线A	嘉定北,嘉定西,白银路,嘉定新城,马陆,南翔,桃浦新村,武威路,祁连山路,李子园,上海西站,真如,枫桥路,曹杨路,隆德路,江苏路,交通大学,徐家汇,上海游泳馆,龙华,云锦路,龙耀路,东方体育中心,三林,三林东,浦三路,御桥,罗山路,秀沿路,康新公路,迪士尼
11号线B	花桥,光明路,兆丰路,安亭,上海汽车城,昌吉东路,上海赛车场,嘉定新城,马陆,南翔,桃浦新村,武威路,祁连山路,李子园,上海西站,真如,枫桥路,曹杨路,隆德路,江苏路,交通大学,徐家汇,上海游泳馆,龙华,云锦路,龙耀路,东方体育中心,三林
12号线	七莘路,虹莘路,顾戴路,东兰路,虹梅路,虹漕路,桂林公园,漕宝路,龙漕路,龙华,龙华中路,大木桥路,嘉善路,陕西南路,南京西路,汉中路,曲阜路,天潼路,国际客运中心,提篮桥,大连路,江浦公园,宁国路,隆昌路,爱国路,复兴岛,东陆路,巨峰路,杨高北路,金京路,申江路,金海路
13号线	金运路,金沙江西路,丰庄,祁连山南路,真北路,大渡河路,金沙江路,隆德路,武宁路,长寿路,江宁路,汉中路,自然博物馆,南京西路,淮海中路,新天地 ,马当路,世博会博物馆,世博大道,长清路,成山路,东明路,华鹏路,下南路,北蔡,陈春东路,莲溪路,华夏中路,中科路,学林路,张江路
16号线	龙阳路,华夏中路,罗山路,周浦东,鹤沙航城,航头东,新场,野生动物园,惠南,惠南东,书院,临港大道,滴水湖
17号线	东方绿洲,朱家角,淀山湖大道,漕盈路,青浦新城,汇金路,赵巷,嘉松中路,徐泾北城,徐盈路,蟠龙路,诸光路,虹桥火车站